學號,姓名,國文,英文,數學,地理,歷史,總分,平均
1,朱彥志,59,65,74,69,85,352,70.4
2,謝佳穎,63,52,86,80,83,364,72.8
3,王士銘,69,60,69,77,67,342,68.4
4,艾巧夫,95,84,53,94,58,384,76.8
5,蔡欣汝,85,92,72,74,79,402,80.4
6,黃偉剛,74,84,73,82,59,372,74.4
7,吳麗卿,90,65,82,71,57,365,73.0
8,李慶亮,54,80,64,63,55,316,63.2
9,柯宜臻,83,60,86,54,90,373,74.6
10,陳筱涵,61,61,50,70,84,326,65.2
